1111111111
10P00CCC01
1000C00C01
110000E001
1111111111
